######################
#**11111##*###*11*####
#*#######111111111####
#*111111111111111111##
###############11111*#
#*11#1*###########111#
#111#11111111111111*1#
#111##111*#########11#
#111111#######*1111*##
#11111111**#####11####
#111111#####111#1##*1#
######111111111111111#
########1111111111110#
######################